--------------------------------------------------------------------------------
--------------------------------------------------------------------------------
--------------------------------------------------------------------------------
--------------------------------------------------------------------------------
--------------------------------------------------------------------------------
--------------------------------------------------------------------------------
--------------**-**-**-**-**-**-**-**-**-**-------------------------------------
--------------**-**-**-**-**-**-**-**-**-**-------------------------------------
--------------------------------------------------------------------------------
--------------**-**-**-**-**-**-**-**-**-**-------------------------------------
--------------**-**-**-**-**-**-**-**-**-**-------------------------------------
---------------------------*----------------------------------------------------
--------------**-**-**-**-**-**-**-**-**-**-------------------------------------
--------------**-**-**-**-**-**-**-**-**-**-------------------------------------
--------------------------------------------------------------------------------
--------------**-**-**-**-**-**-**-**-**-**-------------------------------------
--------------**-**-**-**-**-**-**-**-**-**-------------------------------------
--------------------------------------------------------------------------------
--------------**-**-**-**-**-**-**-**-**-**-------------------------------------
--------------**-**-**-**-**-**-**-**-**-**-------------------------------------
--------------------------------------------------------------------------------
--------------------------------------------------------------------------------
--------------------------------------------------------------------------------
--------------------------------------------------------------------------------
--------------------------------------------------------------------------------